#######################
#       .#            #
#      #   #          #
#      #####          #
#      $ #            #
#        #     @$     #
# ##########          #
#      #   #          #
#      #              #
#           #.        #
#######################